0 0 0 0 0 0 0 0
0 6 0 3 3 2 4 2
0 0 0 3 3 2 4 0
3 3 3 3 3 3 3 3
0 0 0 3 3 0 0 0
0 0 0 3 3 0 0 0
0 0 0 3 3 0 0 0
0 0 0 3 3 0 0 6 